NO ./textures/north_wall.xpm
SO ./textures/south_wall.xpm
WE ./textures/west_wall.xpm
EA ./textures/east_wall.xpm

C 0,220,220
F 100,150,200


111111111111
100000000001
100000000001
10000N000001
111111111111




















































