NO ./textures/north_wall.xpm
SO ./textures/south_wall.xpm
EA ./textures/east_wall.xpm
WE ./textures/west_wall.xpm

C 0,220,220
F 100,150,200


1111111111111111111111111111111111111111111111111111111111111111111
1111111111111111111111111111111000000000000000000000000000000111111
1000000000000000000000000000000000000000000000000000000000000000001
1000000000000000000000000000000000000000000000000000000000000000001
1111101111000000000000000000000000000000000000000000000000000000011
1000000000000000000000000000000000000000000000000000000000000000001
1000000000000000000000000000000000000000000000000000000000000000001
10000N0000000000000000000000000000000000000000000000000000000000001
1111101111000000000000000000000000000000000000000000000000000000011
1000000000000000000000000000000000000000000000000000000000000000001
1000000000000000000000000000000000000000000000000000000000000000001
1000000000000000000000000000000000000000000000000000000000000000001
1000000000000000000000000000000000000000000000000000000000000000001
1000000000000000000000000000000000000000000000000000000000000000001
1000000000000000000000000000000000000000000000000000000000000000001
1000000000000000000000000000000000000000000000000000000000000000001
1000000000000000000000000000000000000000000000000000000000000000001
1000000000000000000000000000000000000000000000000000000000000000001
1000000000000000000000000000000000000000000000000000000000000000001
1000000000000000000000000000000000000000000000000000000000000000001
1000000000000000000000000000000000000000000000000000000000000000001
1000000000000000000000000000000000000000000000000000000000000000001
1000000000000000000000000000000000000000000000000000000000000000001
1111111111111111111111111111111000000000000000000000000000000111111
1111111111111111111111111111111111111111111111111111111111111111111





















































