NO ./textures/1.xpm
SO ./textures/2.xpm
EA ./textures/3.xpm
WE ./textures/4.xpm

C 0,220,220
F 100,150,200


111111111111111111111111
111111111111111111111111
100000000000000000001001
100000000000000000001001
111110111100000000001011
100000000000000000001001
100000000000000000001001
10000N000000000000001001
111110111100000000001011
100000000000000000001001
100000000000000000001001
111111111111111111111111
111111111111111111111111
111111111111111111111111




















































