NO ./textures/north_wall.xpm
SO ./textures/south_wall.xpm
WE ./textures/west_wall.xpm
EA ./textures/east_wall.xpm

F 100,150,200
C 220,220,220

011111111111
100000000001
1000N0000001
111111111111

















































