NO ./textures/gen.xpm
SO ./textures/gen2.xpm
EA ./textures/gen3.xpm
WE ./textures/gen4.xpm   

C 0,220,220
F 100,150,200


111111111111111111111111
100000000000000000001001
1000000000E0000000000 01
111111111111111111111111





















































